111111111111111111111
100000000000000000001
101010111010111010101
101010001010100010101
101010100010001010101
101010110010011010101
100000010000010000001
100100000000000001001
100111011   110111001
1100000110 0110000011
000000000111000000000
100001000010000100001
111101011000110101111
100000000010000000001
100011011010110110001
111010001010100010111
100010101000101010001
101000100010001000101
101110110111011011101
1000000000 0000000001
111111111111111111111