111111111111111
100000000000001
100111101111101
100100000000101
100100111000101
100000010000001
100010000010001
100011111110001
100100000001001
100110000011001
100000000000001
100111101111001
100100101001001
100000000000001
111111111111111